Col_1,Col_2,Col_3,Col_4,Col_5,Col_6,Col_7,Col_8,Col_9,Col_10,Col_11,Col_12,Col_13,Col_14,Col_15
62,52,94,15,89,72,91,70,97,49,22,74,57,21,53
95,97,33,56,83,71,35,14,87,70,72,20,28,12,15
54,10,66,95,54,70,34,78,68,55,39,31,84,55,60
73,10,16,45,17,77,25,94,48,49,25,46,80,21,10
66,56,30,65,28,61,13,42,18,29,68,30,77,89,10
42,65,52,33,30,57,11,49,42,46,33,57,53,10,47
75,44,28,44,25,52,64,84,96,36,88,34,40,37,44
90,71,72,77,76,70,68,91,33,95,21,92,19,27,12
14,66,64,85,17,18,32,41,84,59,47,48,65,28,73
30,60,61,17,20,66,63,85,20,46,45,27,62,86,32
67,41,84,97,76,46,71,28,94,47,49,21,66,68,71
21,76,25,71,59,59,64,63,80,33,64,69,69,42,33
41,18,70,94,86,58,32,91,22,98,11,47,50,24,50
78,48,97,43,19,29,35,27,10,91,88,96,63,35,98
36,20,68,21,28,65,82,72,50,61,16,93,27,31,88
